11111111111111
13000000003031
12303003001001
10003000030001
10004000000001
11111111111111
