11111111111111111111
12100000000000000001
10100100300000000001
10001003300000000011
10300111111003000001
10110000000001100111
10003000100011030031
11111111111111111111
