11111111
15533451
15723251
15155551
15135551
11161111
