11111111111111
12000000003001
10003003001001
10004000000001
10004000000001
11111111111111
