11111111111111
14443555555551
13333555555551
15555555545551
15555555434551
15555555545551
15444445555551
15554555555551
15533355255551
15555555555551
11111111111111
