11111111
15533451
15523251
15555551
15555551
11161111
