11111111111111111111
12300000000000000001
10300000000000000001
10300000000000000001
10300000000000000001
10300000000000000001
10300000000000000001
10300000000000000001
10300000000000000001
10300000000000000001
10300000000000000001
10300000000000000001
10300000000000000001
11111111111111111111
