1111111111111111111
1555555555555555551
1555555555555555551
1555555555555555551
1555555555555555551
1555555555555555551
1555553555555555551
1555553555555555551
1555553555255555551
1111111111111111111
