111111111111111111111111111111111111111111111111111111
155335535553555555535455545354535555354553545535535531
155335535553555555535455545354535555354553545535535531
155335535553555555535455545354535555354553545535535531
155335535553555555535452545354535555354553545535535531
155335535553555555535455545354535555354553545535535531
155335535553555555535455545354535555354553545535535531
155335535553555555535455545354535555354553545535535531
155335535553555555535455545354535555354553545535535531
155335535553555555535455545354535555354553545535535531
155335535553555555535455545354535555354553545535535531
111111111111111111111111111111111111111111111111111111
