11111
13001
12001
10001
14001
10001
10001
10001
10001
11111
