11111111111111111111
12000000131000000001
10000000141000000001
10000000041000000001
10000000030000000001
10000000030000000001
10000000130000000001
10000000140000000001
10000000030000000001
10000000030000000001
10000000040000000001
10000000030000000001
11111111111111111111
