11111111111111
1203000000000000000000000000000000001
12030000000001
12030000000001
12030000000001
12030000000001
12030000000001
12030000000001
11111111111111
