11111111111111
12030000000001
12030000030001
12030000003001
12030000034001
12030000050001
12030000055001
12030000000001
11111111111111
