11111111111111111111
12000000000000000001
13000000000000000001
10000000000000000001
10000000003000000001
10000000003000000001
10000000013100000001
10000000013100000001
13000000013100000001
13300000013100000001
13330000013100000001
11111111111111111111
