11111111111111111111
12000000000303000001
13000330000303000001
13333333333303000001
10000000000001000001
10000000000001000001
10000000000001000001
10011110000000000001
10000000000011000001
10000000000111100001
10000000000000000001
10000000000000000001
10000000000000000001
11111111111111111111
