11111111111111111111
10300000000000000001
10102000000000000001
10000000000000000001
13000000000000000001
13300000000000000001
13330000000000000001
11110000000000000001
10000000000000000001
10003100000000000001
10031000000000000001
10310000000000000001
11111111111111111111
